5 7
@ @ @ @ @ @ @
@ @ . . . @ @
@ . . . . . @
@ @ @ . @ @ @
@ @ @ @ @ @ @
2
3 3 2 3
2 1 2 5
0