8 8
. . . . . @ . . 
. . . . . . @ . 
. . @ . . . . . 
. . . . . . @ . 
. @ . . . . . . 
. . . . . @ . . 
. . . . . . . . 
. . . . . . . . 
7
6 4 2 0
4 5 7 0
1 4 3 3
0 3 6 4
7 0 0 7
5 7 1 5
0 1 0 2
1 1