8 8
. . . . . . . @ 
. . . . . . . . 
. . . . . . . . 
. . @ . . . @ . 
. . . . @ . . . 
. . . . . . . . 
. . . . . . @ . 
. @ . . . . . . 
7
6 7 6 3
1 7 2 6
7 6 7 0
3 5 5 4
5 1 7 5
0 0 6 1
5 2 2 1
0