5 5
@ @ @ @ @
@ . @ . @
@ . . . @
@ . @ . @
@ @ @ @ @
2
2 1 2 3
2 2 1 3
0