16 16
. . . . . . . @ @ . . . . . . . 
. . @ . . . . . . . . . . . . . 
. . . . @ @ . . . . . @ . . . . 
. @ . . . . . . . . . @ . . . . 
. . @ . . . @ . . @ . . . @ . . 
. . . . . . . . . @ . . . . . . 
@ . . @ . . @ . . @ @ . . @ . . 
. . . . . . . . . . . . . . . . 
. @ @ @ @ @ @ . @ @ . . @ . . . 
. . . . . . . . . . . . . . . . 
. . . . @ . . . @ . . @ . . . . 
. @ . . @ . . . . . . . . . . . 
. . . @ . . . @ @ @ . . . @ @ . 
. . . . . . . . . . . @ . . . . 
@ . . @ . . @ . . @ . . @ . . . 
. . . . . . . . . . . . . . . . 
15
2 7 1 6
10 1 7 9
1 4 1 1
7 0 6 14
6 7 1 12
14 5 6 7
6 15 9 8
10 5 6 12
15 15 0 0
0 0 15 15
10 10 2 1
2 1 10 12
13 13 13 0
5 13 7 4
2 10 5 10
12 12 1 15
0