16 16
. . . . . . . . . . . . . . . . 
. . . . . . . . . . . . . . . . 
. . . . @ @ . . . . . . . . . . 
. @ . . @ . . . . . . . . . . . 
. . @ @ . . . . . . . . . . . . 
. . . . . . . . . . . . . . . . 
@ @ @ @ . . . . . . @ . . . . . 
. . . . . . . . . . . . . . . . 
. . . . . . . . . . . . @ . . . 
. . . . . @ . . . . . . . . . . 
. . . . @ . . . @ . . @ . . . . 
. @ . . @ . . . . . . . . . . . 
. . . @ . . . . . . . . . . . . 
. . . . . . . . . @ . @ . . . . 
@ @ @ @ . . . . . @ @ @ @ . . . 
. . . . . . . . . . . . . . . . 
12
2 7 1 6
10 1 7 9
1 4 1 1
7 6 5 4
7 0 6 14
6 7 1 12
5 5 5 6
3 3 5 5
14 6 6 7
4 5 3 2
6 15 9 8
10 5 6 12
0