8 8
@ . . . . . . . 
. . . . . . . . 
. . . . . . . . 
. . @ . . . . . 
@ @ . . . . @ . 
. . . . . . . . 
. . . . . . . @ 
. . . . . . . . 
6
3 4 3 5
5 7 6 6
4 2 7 0
3 1 3 0
5 1 7 6
6 1 6 4
1 1