5 7
@ @ @ @ @ @ @
@ . . . @ . @
@ . . . . . @
@ . . . @ . @
@ @ @ @ @ @ @
2
1 1 3 5
3 1 1 5
0