8 8
. . . . . . . . 
. . . . . . . . 
. . . . . . . . 
. . . . @ . @ . 
. . @ . . . . . 
. . . @ . @ . . 
. . . . . . . @ 
. . . . . . . . 
7
1 6 0 3
1 7 7 1
2 2 6 2
2 5 4 5
0 0 4 6
5 0 7 5
7 4 2 5
1 1