8 8
. . . . . . . . 
. @ . . . . . . 
. . . @ . . . . 
. . . . . @ . . 
. . . . . . @ . 
. . . . . . . . 
. . . . . . . . 
. @ . . . . @ . 
6
3 0 5 3
2 5 4 1
7 3 2 5
5 1 1 5
0 6 6 4
1 3 1 2
0