8 8
. . . . . @ @ . 
@ . . . . . . . 
. . . . . . . . 
. . @ . . @ . . 
. . . . . . . . 
. . . . . . . . 
. . . . . @ . . 
. . . . . . . . 
6
5 0 7 0
7 4 5 7
5 1 3 7
0 2 2 4
1 7 3 3
0 7 7 5
1 1