16 16
. . . . . . . . . . . . . . . . 
. . . . . . . . . . . . . . . . 
. . . . @ @ . . . . . . . . . . 
. @ . . . . . . . . . . . . . . 
. . @ . . . . . . . . . . . . . 
. . . . . . . . . . . . . . . . 
@ . . @ . . . . . . @ . . . . . 
. . . . . . . . . . . . . . . . 
. . . . . . . . . . . . @ . . . 
. . . . . . . . . . . . . . . . 
. . . . @ . . . @ . . @ . . . . 
. @ . . @ . . . . . . . . . . . 
. . . @ . . . . . . . . . . . . 
. . . . . . . . . . . @ . . . . 
@ . . @ . . . . . @ . . @ . . . 
. . . . . . . . . . . . . . . . 
25
2 7 1 6
10 1 7 9
1 4 1 1
7 6 5 4
7 0 6 14
6 7 1 12
5 5 5 6
3 3 5 5
14 6 6 7
4 5 3 2
6 15 9 8
10 5 6 12
15 15 0 0
0 0 15 15
10 10 2 1
2 1 10 12
12 13 13 0
5 12 8 4
2 10 5 10
12 12 1 15
2 0 0 11
15 1 4 15
2 2 2 7
3 5 15 2
4 15 5 0
1 1 0 15
1 1