8 8
. . . . . . . . 
. . @ . . . . . 
@ . . . . . @ . 
. . . . . . . . 
. . . . . . @ . 
. . . . . . . . 
. . . . . @ @ . 
. . . . . . . . 
6
7 3 2 2
0 4 1 5
5 4 1 4
7 6 4 3
4 2 4 0
2 3 5 4
0
