6 7
@ @ @ @ @ @ @
@ @ @ . @ @ @
@ . . . . . @
@ . . . . . @
@ . . . . . @
@ @ @ @ @ @ @
2
2 1 2 5
4 1 4 5
1 3