8 8
@ . . . . . . . 
. . . . . @ @ . 
. @ . . @ . . . 
. . . . . . . . 
. . . . . . @ . 
. . . . . . . . 
. . . . . . . . 
. . . . . . . . 
7
3 0 3 0
2 7 5 7
5 3 5 0
4 3 7 4
2 3 1 4
7 1 4 3
5 7 7 2
0