5 7
@ @ @ @ @ @ @
@ @ @ . . . @
@ . . . . . @
@ @ @ . @ @ @
@ @ @ @ @ @ @
2
2 2 2 4
2 1 2 5
1 1

