8 8
. . . . @ @ . @ 
. . . . . . . . 
. . . @ . . . . 
. . . . . . . . 
. @ . . . . . . 
. . . . . . . . 
. . . . . . . . 
. . . @ . . . . 
7
5 0 5 4
4 0 4 5
7 1 7 5
2 5 0 1
0 2 3 0
6 4 4 2
1 6 7 7
1 1