8 8
. . . @ . . . . 
. . . . . . . . 
. . . . . . . . 
. . . . . . . @ 
@ @ . . . . . . 
. . . . @ . . . 
. . . . . . . . 
. @ . . . . . . 
7
5 5 2 6
6 0 5 5
5 3 2 1
4 3 3 2
5 1 1 2
2 1 1 4
3 3 2 0
1 1