8 8
. @ . . @ . . . 
. . . . . . . . 
. . . . . @ . . 
. . . . . . . . 
. . . . . . @ . 
. . . . . @ . . 
. . . . . . . . 
. @ . . . . . . 
7
5 1 5 2
7 0 1 0
7 4 7 0
0 5 1 3
6 3 3 6
6 1 3 7
1 6 4 5
0