8 8
. . . . . . . . 
. . . . . . . . 
. . . @ . @ . . 
. . . . . . . . 
@ . . . @ . . . 
. . . . . @ . . 
. . . . . . . . 
. . . @ . . . . 
7
0 3 5 1
0 5 7 0
4 1 1 3
7 1 7 7
2 6 3 7
3 7 4 3
2 7 7 2
0