8 8
. . . . . . . . 
@ @ . . . . . . 
. . . @ . . . . 
@ . . . . . . . 
. @ . . . . . . 
. . . . . . . @ 
. . . . . . . . 
. . . . . . . . 
7
0 4 0 3
2 4 5 4
0 5 6 0
2 1 6 6
5 2 6 2
1 5 4 2
4 3 1 2
1 1