5 8
@ @ @ @ @ @ @ @
@ @ @ . @ @ @ @
@ . . . ~ . . @
@ @ @ . @ @ @ @
@ @ @ @ @ @ @ @
2
2 2 2 5
2 1 2 6
1
3 3
