9 14
@ @ @ @ @ @ @ @ @ @ @ @ @ @
. . . . . . . . . . . . . .
. . . . @ @ @ @ @ @ @ @ @ @
. . . . ~ . ~ . ~ . ~ . . .
. . . . @ @ @ @ @ @ @ @ @ @
. . . . . . . . . . . . . .
. . . . . . . . . . . . . .
. . . . . . . . . . . . . .
@ @ @ @ @ @ @ @ @ @ @ @ @ @
2
1 0 3 13
5 0 3 12
4
7 4
7 5
7 6
7 7