7 9
. . . . . . . . .
. . . @ @ @ @ @ @
. . . . . . . . @
. . . @ @ @ @ . @
. . . . . . @ . @
. . . . . . @ ~ @
. . . . . . @ . @
1
2 0 6 7
1
6 2
