6 7
@ @ @ @ @ @ @
@ @ @ . @ @ @
@ . . . @ . @
@ . . . ~ . @
@ . . . @ . @
@ @ @ @ @ @ @
1
3 1 3 5
1 3