8 12
@ @ @ @ @ @ @ @ @ @ @ @ 
@ @ @ @ @ @ @ @ @ @ @ @
@ @ . . . . . . . . . @
@ @ @ . @ @ @ @ @ @ @ @
@ . . . ~ . . . . . . @
@ . . . @ . . . . . . @
@ . . . @ . . . . . . @
@ @ @ @ @ @ @ @ @ @ @ @
2
4 1 4 5
2 10 2 2
1
2 3