5 7
@ @ @ @ @ @ @
@ @ @ . . . @
@ . ~ . . . @
@ @ @ . @ @ @
@ @ @ @ @ @ @
1
2 1 2 5
1
3 3

