7 10
@ @ @ @ @ @ @ @ @ @
. . . . . . . . . .
. . . . @ @ @ @ @ @
. . . . ~ . . ~ . .
. . . . @ @ @ @ @ @
. . . . . . . . . .
@ @ @ @ @ @ @ @ @ @
1
3 0 3 9
2
1 9
5 9