5 7
@ @ @ @ @ @ @
@ @ @ . . . @
. . ~ . . . @
@ @ @ . @ @ @
@ @ @ @ @ @ @
2
2 1 2 4
2 0 2 5
1
3 3

