5 7
@ @ @ . @ @ @
@ . . . @ . @
@ . . . @ . @
@ . . . ~ . @
@ @ @ @ @ @ @
1
3 3 3 5
1
0 3