5 7
@ @ . . @ @ @
@ . . . ~ . @
@ . . . @ . @
@ . . . ~ . @
@ @ @ @ @ @ @
2
1 1 1 5
3 1 3 5
2
0 3
0 2